29 28
1 1 1 1 1 1 1 1 1 0 0 0 1 0 1 0 0 0 1 1 1 1 1 1 1 1 1 1 
1 0 0 0 0 0 0 0 1 0 0 0 1 0 1 0 0 0 1 3 2 2 2 2 2 2 2 1 
1 0 1 1 1 1 1 0 1 0 0 0 1 0 1 0 0 0 1 2 1 1 1 1 1 1 2 1 
1 0 1 0 0 0 1 0 1 1 1 1 1 0 1 1 1 1 1 2 1 0 0 0 0 1 2 1 
1 0 1 1 1 1 1 0 2 2 2 2 2 0 0 0 0 0 0 0 1 1 1 1 1 1 2 1 
1 0 2 2 2 2 2 0 1 1 1 1 1 0 1 1 1 1 1 0 2 2 2 2 2 2 2 1 
1 0 1 1 1 1 1 0 0 0 0 0 0 0 2 2 2 2 2 0 1 1 1 1 1 1 2 1 
1 0 1 1 1 1 1 1 2 1 1 1 1 0 1 1 1 1 1 0 1 1 1 1 1 1 2 1 
1 0 0 0 0 2 2 2 2 1 1 1 1 0 1 1 1 1 1 0 2 2 2 2 2 2 2 1 
1 1 1 1 0 1 1 1 2 1 0 0 0 0 0 0 0 0 1 0 1 1 1 2 1 1 1 1 
0 0 0 1 0 1 0 1 2 1 0 1 1 0 0 1 1 0 1 0 1 0 1 2 1 0 0 0 
0 0 0 1 0 1 0 1 2 1 0 1 0 0 0 0 1 0 1 0 1 0 1 2 1 0 0 0 
0 0 0 1 0 1 0 1 2 3 0 1 0 0 0 0 1 0 3 0 1 0 1 2 1 0 0 0 
1 1 1 1 0 1 1 1 2 1 0 1 1 0 0 1 1 0 1 0 1 1 1 2 1 1 1 1 
0 0 0 0 0 0 0 0 0 1 0 0 0 0 0 0 0 0 1 0 0 0 0 0 0 0 0 0 
1 1 1 1 0 1 1 1 0 1 1 1 1 1 0 1 1 1 1 0 1 1 1 0 1 1 1 1 
0 0 0 1 0 1 1 1 0 1 1 1 1 1 0 1 1 1 1 0 1 1 1 0 1 0 0 0 
0 0 0 1 0 0 0 0 0 0 0 0 0 0 0 0 0 0 0 0 0 0 0 0 1 0 0 0 
0 0 0 1 0 1 1 1 1 1 0 1 1 1 1 1 1 0 1 1 1 1 1 0 1 0 0 0 
0 0 0 1 0 1 0 0 0 1 0 1 0 0 0 0 1 0 1 0 0 0 1 0 1 0 0 0 
1 1 1 1 0 1 1 1 1 1 0 1 1 1 1 1 1 0 1 1 1 1 1 0 1 1 1 1 
1 0 0 0 0 0 0 0 0 0 0 0 0 9 0 0 0 0 0 0 0 0 0 0 0 0 0 1 
1 0 1 0 1 1 1 1 1 1 1 1 1 0 1 1 1 1 1 1 1 1 1 1 0 1 0 1 
1 0 1 0 1 0 0 0 0 0 0 0 0 0 0 0 0 0 0 0 0 0 0 1 0 1 0 1 
1 0 0 0 1 0 1 0 1 1 1 1 1 0 1 1 1 1 1 0 1 1 0 1 0 0 0 1 
1 0 1 1 1 0 1 0 1 0 0 0 1 0 1 0 0 0 1 0 1 1 0 1 1 1 0 1 
1 0 1 1 1 0 1 0 1 0 0 0 1 0 1 1 1 1 1 0 1 1 0 1 1 1 0 1 
1 0 0 0 0 0 0 0 1 0 0 0 1 0 0 0 0 0 0 0 1 1 0 0 0 0 0 1 
1 1 1 1 1 1 1 1 1 0 0 0 1 0 1 1 1 1 1 1 1 1 1 1 1 1 1 1 
4
0 11 14 12 15 0 1
0 21 15 12 14 0 -1
0 9 11 12 13 0 1
0 9 13 12 12 0 1
21 6 21 13 0 -1 0 0 2
2 4980